MapName: "Baidybop Map Pack";
MapLength: "50";
MapHeight: "50";
MapData:
"11111111111111111111111111111111111111111111111111
10000010000000000000000000000000000000000000000001
10000000000000000000000000000000000000000000000001
10000000000000000000000000001111000000000000000001
10000000000000000000000000110001111000000000000001
10000000000000000000000000000000001110000000000001
10000000000000000000000011000000000001100000000001
11000011111000000000000010000000000000011000000001
10000000000110000000000000000000000000000100000001
10000000000000011000000000000000000000000110000001
10000000000000001000000000000010000000000000000001
10000000000000001100000000000010000000000000000001
10000000000000000100001000000010000000000010000001
10000000000000000100001000000010000000000010000001
10000000000000000100001000000010000000000010000001
10000000000000000100001000000010000000000010000001
10000000000000000000001000000010000000000010000001
10000000000000000100000000000010000000000000000001
10000000000000000100000000000010000000000100000001
10000000000000000100000000000010000000001000000001
10000000000000000100001000000000011000001000000001
10000000000000000100001000000001110000010000000001
10000000000000000000001000001111000000100000000001
10000000000000001000001000001000000011000000000001
10000000000000001000001110011000000110000000000001
10000000000000100000000011110000001100000000000001
10000000011111100000000000000000110000000000000001
10000111110000000000000000000011000000000000000001
10000110000000000000000000011110000000000000000001
10000011000000000000000011110000000000000000000001
10000001111110111000011110000000000000000000000001
10000000000000000111100000000000000000000001100001
10000100000000000000000000000000000000000011000001
10000100000000000000000000000000000000011100000001
10000100000000000000000000000000000001110000000001
10000100000000000000000000000000001110000000000001
10000000000001110000000000000001110110000000000001
10000100000000011000000000001010000010000000000001
10000100000000001100000000111000000010000000000001
10001100000000000111100111100000000001000000000001
10001000000000000000110100000000000001000000000001
10000000000000000000001110000000000001100000000001
10000000000000000000000011000000000000100000000001
10000000000000000000000000000000000000010000000001
10000000000000000000000000000000000000010000000001
10000000000000000000000000000000000000001000000001
10000000000000000000000000000000000000001100000001
10000000000000000000000000000000000000000000000001
10000000000000000000000000000000000000000000000001
11111111111111111111111111111111111111111111111111";