MapName: "Cross Thang";
MapLength: "60";
MapHeight: "60";
MapData:
"111111111111111111111111111111111111111111111111111111111111
111111111111111111111000000000000000000111111111111111111111
111111111111111111111000000000000000000111111111111111111111
111111111111111111111000000000000000000111111111111111111111
111111111111111111111000000000000000000111111111111111111111
111111111111111111111000000000000000000111111111111111111111
111111111111111111111000000000000000000111111111111111111111
111111111111111111111000000000000000000111111111111111111111
111111111111111111111000000000000000000111111111111111111111
111111111111111111111000000000000000000111111111111111111111
111111111111111111111000000000000000000111111111111111111111
111111111111111111111000000000000000000111111111111111111111
111111111111111111111000000000000000000111111111111111111111
111111111111111111111000000000000000000111111111111111111111
111111111111111111111000000000000000000111111111111111111111
111111111111111111111000000000000000000111111111111111111111
111111111111111111111000000000000000000111111111111111111111
111111111111111111111000000000000000000111111111111111111111
111111111111111111111000000000000000000111111111111111111111
111111111111111111111000000000000000000111111111111111111111
111111111111111111111000000000000000000111111111111111111111
100000000000000000000000000000000000000000000000000000000001
100000000000000000000011000000000000110000000000000000000001
100000000000000000000011100000000001110000000000000000000001
100000000000000000000001110000000011100000000000000000000001
100000000000000000000000111000000111000000000000000000000001
100000000000000000000000010000000110000000000000000000000001
100000000000000000000000000010010000000000000000000000000001
100000000000000000000000000111111000000000000000000000000001
100000000000000000000000000011110000000000000000000000000001
100000000000000000000000000011110000000000000000000000000001
100000000000000000000000000111111000000000000000000000000001
100000000000000000000000000010010000000000000000000000000001
100000000000000000000000011000000110000000000000000000000001
100000000000000000000000111000000111000000000000000000000001
100000000000000000000001110000000011100000000000000000000001
100000000000000000000011100000000001110000000000000000000001
100000000000000000000011000000000000110000000000000000000001
100000000000000000000000000000000000000000000000000000000001
111111111111111111111000000000000000000111111111111111111111
111111111111111111111000000000000000000111111111111111111111
111111111111111111111000000000000000000111111111111111111111
111111111111111111111000000000000000000111111111111111111111
111111111111111111111000000000000000000111111111111111111111
111111111111111111111000000000000000000111111111111111111111
111111111111111111111000000000000000000111111111111111111111
111111111111111111111000000000000000000111111111111111111111
111111111111111111111000000000000000000111111111111111111111
111111111111111111111000000000000000000111111111111111111111
111111111111111111111000000000000000000111111111111111111111
111111111111111111111000000000000000000111111111111111111111
111111111111111111111000000000000000000111111111111111111111
111111111111111111111000000000000000000111111111111111111111
111111111111111111111000000000000000000111111111111111111111
111111111111111111111000000000000000000111111111111111111111
111111111111111111111000000000000000000111111111111111111111
111111111111111111111000000000000000000111111111111111111111
111111111111111111111000000000000000000111111111111111111111
111111111111111111111000000000000000000111111111111111111111
111111111111111111111111111111111111111111111111111111111111";