MapName: "newPF";
MapLength: "21";
MapHeight: "21";
MapData:
"111111111111111111111
100000000000000000001
100000000000000000001
100000000000010000001
100000000000010000001
100000000000010000001
111111111111110000001
100000000000000000001
100000000000000000001
100000000000000000001
100001111111111111111
100000000000000000001
100000000000000000001
100000000000000000001
100000000000000000001
100000000000000000001
100000000000000000001
100000000000000000001
100000000000000000001
1111111111111111111111";